6
#S#################
#.....####.....####
####..#############
####.#########.####
####.#########.####
####...#######.####
######.#####...####
#####..###..#######
#.....####....#####
##.##.#############
##.##........######
##.#########.######
##....######.#...##
#####.##..##.######
#####.####...######
#####.####.########
##...............##
################.##
###..............##
###E###############

###################
#.....####.....####
####S.#############
####.#########.####
####.#########.####
####...#######.####
######.#####...####
#####..####....####
#.....###........##
#####.#############
#####........######
##......####.######
############.######
########..##.#...##
##########..#######
##########.########
##...............##
###################
###..............##
###E###############

###################
###################
####..#############
###################
####.#########.####
####...#######.####
######.#####...####
#####..############
#.....#############
#####.#############
#####........######
############.######
############.######
########..##.######
##########..#######
##########S########
###################
###.......######.##
###################
###E###############

###################
#.................#
####..##.......####
#####.........#####
####.####..###.####
####...#######.####
######.#####...####
#####..######.#####
#.....####......###
############....###
#####........######
############.######
##...#######.##..##
###..###..#..######
##########..##...##
##........S.....###
##########.########
##########..####.##
######......#######
###E###...#########

###################
#.....####.....####
####..#############
####.#########.####
####.#########.####
####...#######.####
######.#####...####
#####..############
#.....#####SE######
#####.#############
#####........######
############.######
############.######
########..##.######
##########..#######
##########.########
##...............##
################.##
###..............##
###################

###################
###################
#####SE############
###################
###################
###################
###################
###################
###################
###################
###################
###################
###################
###################
###################
###################
###################
###################
###################
###################
